10 5
0 0 2
9 4 8
1 10 6 3 10 6 3 10 10 6
5 11 12 9 6 9 4 7 3 12
9 6 3 14 1 6 9 12 5 7
3 8 12 3 4 9 14 3 8 12
9 10 10 12 9 14 11 8 10 6
